148;GGGGGGGGGG
132;GGGGGGGGGG
100;RRRRRRRRRR
84;GGGGGGGGGG
68;GGGGGGGGGG
52;RRRRRRRRRR
36;GGGGGGGGGG
11;GGGGGGGGGG
